1,1,1,1,1,1,1,1,1,1,1,1,1,1,1,1,1,1,1,1,1,1,1,1,1,1,1,1,1,1,1,1,1,1
1,1,2,2,2,2,2,2,2,2,2,2,2,1,2,2,2,2,2,2,2,2,2,2,2,2,2,5,2,2,2,2,1,1
1,1,2,2,2,2,2,2,2,2,2,2,2,1,2,2,2,2,2,2,2,2,2,2,2,2,2,2,2,2,2,2,1,1
1,1,2,2,1,2,2,1,2,2,1,2,2,1,2,2,1,1,1,1,1,2,2,1,2,2,1,1,1,1,2,2,1,1
1,1,2,2,2,2,2,2,2,2,1,4,2,1,2,2,2,2,2,2,2,2,2,2,2,2,2,2,2,1,2,2,1,1
1,1,2,2,2,2,2,2,2,2,1,2,2,1,2,2,2,2,2,2,2,2,2,2,2,2,2,2,2,1,2,2,1,1
1,1,2,2,1,1,1,1,1,1,1,2,2,1,2,2,1,1,1,1,1,2,2,1,2,2,1,2,2,1,2,2,1,1
1,1,2,2,2,2,2,2,2,2,2,2,2,1,2,2,2,2,2,2,2,2,2,2,2,2,2,2,2,2,2,2,1,1
1,1,2,2,2,2,2,2,2,2,2,2,2,1,2,2,2,2,2,2,2,2,2,2,2,2,2,2,2,2,2,2,1,1
1,1,2,2,1,2,2,1,2,2,1,2,2,1,2,2,1,1,1,2,2,1,1,1,2,2,1,2,2,1,2,2,1,1
1,1,2,2,1,2,2,1,2,2,2,2,2,2,2,2,2,2,2,2,2,2,2,2,2,2,2,2,2,2,2,2,1,1
1,1,2,2,1,2,2,1,2,2,2,2,2,2,2,2,2,2,2,2,2,2,2,2,2,2,2,2,2,2,2,2,1,1
1,1,2,2,1,2,2,1,2,2,1,2,2,1,1,1,2,2,1,1,1,2,2,1,1,1,1,2,2,1,2,2,1,1
1,1,2,2,2,2,2,2,2,2,2,2,2,1,3,3,3,3,3,3,1,2,2,1,2,2,2,2,2,1,2,2,1,1
1,1,2,2,2,2,2,2,2,2,2,2,2,1,3,3,3,3,3,3,1,4,2,1,2,2,2,2,2,1,2,2,1,1
1,1,2,2,1,1,1,1,2,2,1,2,2,1,1,1,2,2,1,1,1,2,2,1,2,2,1,2,2,1,2,2,1,1
1,1,2,2,1,2,2,2,2,2,2,2,2,2,2,2,2,2,2,2,2,2,2,2,2,2,2,2,2,2,2,2,1,1
1,1,2,2,1,2,2,2,2,2,2,2,2,2,2,2,2,2,2,2,2,2,2,2,2,2,2,2,2,2,2,2,1,1
1,1,2,2,1,2,2,1,1,1,1,2,2,1,2,2,1,1,2,2,1,2,2,1,1,1,1,1,1,1,2,2,1,1
1,1,2,2,2,2,2,2,2,2,2,5,2,1,2,2,2,2,2,2,2,2,2,2,2,2,2,2,2,1,2,2,1,1
1,1,2,2,2,2,2,2,2,2,2,2,2,1,2,2,2,2,2,2,2,2,2,2,2,2,2,2,2,1,2,2,1,1
1,1,1,1,1,1,1,1,1,1,1,2,2,1,2,2,1,1,1,1,1,2,2,1,2,2,1,2,2,1,2,2,1,1
1,1,2,2,2,2,2,2,2,2,2,2,2,2,2,2,2,2,2,2,2,2,2,1,6,2,2,2,2,2,2,2,1,1
1,1,2,2,2,2,2,2,2,2,2,2,2,2,2,2,2,2,2,2,2,2,2,1,2,2,2,2,2,2,2,2,1,1
1,1,2,2,1,2,2,1,2,2,1,4,2,1,2,2,1,2,2,1,1,2,2,1,1,2,2,1,1,1,2,2,1,1
1,1,2,2,1,2,2,1,2,2,1,2,2,1,2,2,1,2,2,1,1,2,2,1,1,2,2,1,0,1,2,2,1,1
1,1,2,2,1,2,2,1,2,2,1,2,2,1,2,2,1,2,2,1,1,2,2,1,1,2,2,1,1,1,2,2,1,1
1,1,2,2,2,2,2,2,2,2,2,2,2,2,2,2,2,2,2,2,2,2,2,2,2,2,2,2,2,2,2,2,1,1
1,1,2,2,2,2,2,2,2,2,2,2,2,2,2,2,2,2,2,2,2,2,2,2,2,2,2,2,2,2,2,2,1,1
1,1,1,1,1,1,1,1,1,1,1,1,1,1,1,1,1,1,1,1,1,1,1,1,1,1,1,1,1,1,1,1,1,1